1111111111111
1001000000C1
1000011111001
1P0011CE00001
1111111111111